15
100
3 34 34 34 34 34 34 34 34 34 34 34 34 34 4 
38 0 0 0 0 0 0 0 0 0 0 0 0 0 38 
37 0 0 0 0 0 0 0 0 0 0 0 0 0 37 
37 0 0 0 0 0 0 0 0 0 0 0 0 0 37 
37 0 0 0 0 0 0 0 0 0 0 0 0 0 37 
37 0 0 0 0 0 0 0 0 0 0 0 0 0 37 
36 0 0 0 0 0 0 0 0 0 0 0 0 0 36 
30 34 34 34 34 34 34 4 0 3 34 34 34 34 30 
38 0 0 0 0 0 0 0 0 0 0 0 0 0 38 
37 0 0 0 0 0 0 0 0 0 0 0 0 0 37 
37 0 0 0 0 0 0 0 0 0 0 0 0 0 37 
37 0 0 0 0 0 0 0 0 0 0 0 0 0 37 
37 0 0 0 0 0 0 0 0 0 0 0 0 0 37 
36 0 0 0 0 0 0 0 0 0 0 0 0 0 36 
37 0 0 0 0 0 0 0 0 0 0 0 0 0 37 
37 0 0 0 0 0 0 0 0 0 0 0 0 0 37 
36 0 0 0 0 0 0 0 0 0 0 0 0 0 36 
36 0 0 3 34 34 34 34 34 34 34 34 34 34 30
38 0 0 0 0 0 0 0 0 0 0 0 0 0 38 
37 0 0 0 0 0 0 0 0 0 0 0 0 0 37 
37 0 0 0 0 0 0 0 0 0 0 0 0 0 37 
37 0 0 0 0 0 0 0 0 0 0 0 0 0 37 
37 0 0 0 0 0 0 0 0 0 0 0 0 0 37 
36 0 0 0 0 0 0 0 0 0 0 0 0 0 36 
30 34 34 34 34 34 34 34 34 4 0 0 0 0 30
38 0 0 0 0 0 0 0 0 0 0 0 0 0 38 
37 0 0 0 0 0 0 0 0 0 0 0 0 0 37 
37 0 0 0 0 0 0 0 0 0 0 0 0 0 37 
37 0 0 0 0 0 0 0 0 0 0 0 0 0 37 
37 0 0 0 0 0 0 0 0 0 0 0 0 0 37 
36 0 0 0 0 0 0 0 0 0 0 0 0 0 36 
30 34 34 34 34 34 34 4 0 3 34 34 34 34 30 
38 0 0 0 0 0 0 0 0 0 0 0 0 0 38 
37 0 0 0 0 0 0 0 0 0 0 0 0 0 37 
37 0 0 0 0 0 0 0 0 0 0 0 0 0 37 
37 0 0 0 0 0 0 0 0 0 0 0 0 0 37 
37 0 0 0 0 0 0 0 0 0 0 0 0 0 37 
36 0 0 0 0 0 0 0 0 0 0 0 0 0 36 
37 0 0 0 0 0 0 0 0 0 0 0 0 0 37 
37 0 0 0 0 0 0 0 0 0 0 0 0 0 37 
36 0 0 0 0 0 0 0 0 0 0 0 0 0 36 
36 0 0 3 34 34 34 34 34 34 34 34 34 34 30 
38 0 0 0 0 0 0 0 0 0 0 0 0 0 38 
37 0 0 0 0 0 0 0 0 0 0 0 0 0 37 
37 0 0 0 0 0 0 0 0 0 0 0 0 0 37 
37 0 0 0 0 0 0 0 0 0 0 0 0 0 37 
37 0 0 0 0 0 0 0 0 0 0 0 0 0 37 
36 0 0 0 0 0 0 0 0 0 0 0 0 0 36 
30 33 34 33 34 33 34 33 34 4 0 0 0 0 30
38 0 0 0 0 0 0 0 0 0 0 0 0 0 38 
37 0 0 0 0 0 0 0 0 0 0 0 0 0 37 
37 0 0 0 0 0 0 0 0 0 0 0 0 0 37 
37 0 0 0 0 0 0 0 0 0 0 0 0 0 37 
37 0 0 0 0 0 0 0 0 0 0 0 0 0 37 
36 0 0 0 0 0 0 0 0 0 0 0 0 0 36 
30 34 34 34 34 34 34 4 0 3 34 34 34 34 30 
38 0 0 0 0 0 0 0 0 0 0 0 0 0 38 
37 0 0 0 0 0 0 0 0 0 0 0 0 0 37 
37 0 0 0 0 0 0 0 0 0 0 0 0 0 37 
37 0 0 0 0 0 0 0 0 0 0 0 0 0 37 
37 0 0 0 0 0 0 0 0 0 0 0 0 0 37 
36 0 0 0 0 0 0 0 0 0 0 0 0 0 36 
37 0 0 0 0 0 0 0 0 0 0 0 0 0 37 
37 0 0 0 0 0 0 0 0 0 0 0 0 0 37 
36 0 0 0 0 0 0 0 0 0 0 0 0 0 36 
36 0 0 3 34 34 34 34 34 34 34 34 34 34 30 
38 0 0 0 0 0 0 0 0 0 0 0 0 0 38 
37 0 0 0 0 0 0 0 0 0 0 0 0 0 37 
37 0 0 0 0 0 0 0 0 0 0 0 0 0 37 
37 0 0 0 0 0 0 0 0 0 0 0 0 0 37 
37 0 0 0 0 0 0 0 0 0 0 0 0 0 37 
36 0 0 0 0 0 0 0 0 0 0 0 0 0 36 
30 34 34 34 34 34 34 34 34 4 0 0 0 0 36
38 0 0 0 0 0 0 0 0 0 0 0 0 0 38 
37 0 0 0 0 0 0 0 0 0 0 0 0 0 37 
37 0 0 0 0 0 0 0 0 0 0 0 0 0 37 
37 0 0 0 0 0 0 0 0 0 0 0 0 0 37 
37 0 0 0 0 0 0 0 0 0 0 0 0 0 37 
36 0 0 0 0 0 0 0 0 0 0 0 0 0 36 
30 34 34 34 34 34 34 4 0 3 34 34 34 34 30 
38 0 0 0 0 0 0 0 0 0 0 0 0 0 38 
37 0 0 0 0 0 0 0 0 0 0 0 0 0 37 
37 0 0 0 0 0 0 0 0 0 0 0 0 0 37 
37 0 0 0 0 0 0 0 0 0 0 0 0 0 37 
37 0 0 0 0 0 0 0 0 0 0 0 0 0 37 
36 0 0 0 0 0 0 0 0 0 0 0 0 0 36 
37 0 0 0 0 0 0 0 0 0 0 0 0 0 37 
37 0 0 0 0 0 0 0 0 0 0 0 0 0 37 
36 0 0 0 0 0 0 0 0 0 0 0 0 0 36 
36 0 0 3 34 34 34 34 34 34 34 34 34 34 30 
38 0 0 0 0 0 0 0 0 0 0 0 0 0 38 
37 0 0 0 0 0 0 0 0 0 0 0 0 0 37 
37 0 0 0 0 0 0 0 0 0 0 0 0 0 37 
37 0 0 0 0 0 0 0 0 0 0 0 0 0 37 
37 0 0 0 0 0 0 0 0 0 0 0 0 0 37 
36 0 0 0 0 0 0 0 0 0 0 0 0 0 36 
30 34 34 34 34 34 34 34 34 4 0 0 0 0 30
36 0 0 0 0 0 0 0 0 0 0 0 0 0 37
36 0 0 0 0 0 0 0 0 0 0 0 0 0 37
33 34 34 34 34 34 34 34 34 34 34 34 34 34 33
